1111111111111111111
1P00000000000100001
1000000100000110001
100C00010000000C001
1000000000000110001
1010000000001100C01
10000CC00E000110001
1111111111111111111