1111111111111111111
1PCE000000000100001
1000000000000110001
1C00000100000000001
100000C000000110001
1000000000001100001
10C0000000000110001
1111111111111111111


