1111111111111111111111111111111111111
1000000000000010000010010000000000001
100000000000000100001000000000C000001
1000000010000000000010000000E00010001
1000000000010000000010000000100000P01
1111111111111111111111111111111111111
